
F 0,1,00
C 0,0,0

NO texture/NO.xpm
SO texture/SO.xpm
WE texture/WE.xpm
EA texture/EA.xpm

11111111111111111111
11111111111111111111
1000000000011S1111
111111111111110001
111111111111111111111111111
