

F 0,0,0
C 0,0,0

NO texture/NO.xpm
SO texture/SO.xpm
WE texture/WE.xpm
EA texture/EA.xpm

111111
1001111111
1N01
1111
