NO texture/NO.xpm
SO texture/SO.xpm
WE texture/WE.xpm
EA texture/EA.xpm

F 20,20,20
C 200,200,200

11111
10001
10S01
10001
10101
10001
11001
10011
10011
10011
10011
10011
11101
