NO /Users/asebrani/Downloads/5a6d1b2bfc4f3b98639fa199c9c48d0d.xpm
SO /Users/asebrani/Downloads/ff9e205686e2676692e95a62732f654c.xpm
WE /Users/asebrani/Downloads/03ba785863e1857795cb846306370b71.xpm
EA /Users/asebrani/Downloads/03aabd53ed7fb373e2736d68aabca2ed.xpm

F 220,255,0
C 225,30,0


111111111
100000011
100010001
100000001
100N00001
100000001
111111111