NO /Users/asebrani/Desktop/cube/cube3d/parse.c
SO /Users/asebrani/Desktop/cube/cube3d/parse_2.c
WE /Users/asebrani/Desktop/cube/cube3d/map_init.c
EA /Users/asebrani/Desktop/cube/cube3d/check_data.c

F 220,255,0
C 225,30,0



1111111111111111111111111
1000000000110111000000001
1011000001110000000000001
1011110000000000000000001
111111111011000001110000000000001
100000000011000001110111111111111
11110111111111011100000010001
11110111111111011101010010001
11000000110101011100000010001
10000000000000001100000010001
10000000000000001101010010001
11000001110101011111011110W0111
11110111 1110101101111010001
11111111 1111111 11111111111
