NO /Users/asebrani/Downloads/5a6d1b2bfc4f3b98639fa199c9c48d0d.xpm
SO /Users/asebrani/Downloads/5a6d1b2bfc4f3b98639fa199c9c48d0d.xpm
WE /Users/asebrani/Downloads/5a6d1b2bfc4f3b98639fa199c9c48d0d.xpm
EA /Users/asebrani/Downloads/5a6d1b2bfc4f3b98639fa199c9c48d0d.xpm
F 220,255,0
C 225,30,0

11111111111111111111111111111
10000000000000111111111111111
100000E0010000000000000000011
11111111111111111111111111111
