NO /Users/asebrani/Downloads/NO.xpm
SO /Users/asebrani/Downloads/SO.xpm
WE /Users/asebrani/Downloads/WE.xpm
EA /Users/asebrani/Downloads/EA.xpm

F 0,255,0
C 255,200,0

11111111111111111111
100000000000001111111111111
10000000000000E00000000111
111111111111111111111111111
