NO /Users/asebrani/Downloads/5a6d1b2bfc4f3b98639fa199c9c48d0d.xpm
SO /Users/asebrani/Downloads/5a6d1b2bfc4f3b98639fa199c9c48d0d.xpm
WE /Users/asebrani/Downloads/5a6d1b2bfc4f3b98639fa199c9c48d0d.xpm
EA /Users/asebrani/Downloads/5a6d1b2bfc4f3b98639fa199c9c48d0d.xpm
F 220,255,0
C 225,30,0

111111111111111111111
101000001000000000001
101010101011111110001
100010100010000010001
111110101111101011101
100000101000101000001
101111101011101111111
101000N01010100000101
101011111010111110101
101010001010100010101
101110101010101010101
100000101010001010001
111111101011111011101
100000101000100010001
101111001110101110111
101000100000100010101
101011111111111010101
100010000000000010001
101010111011111111101
111000001000000000001
111111111111111111111
