NO /Users/asebrani/Downloads/5a6d1b2bfc4f3b98639fa199c9c48d0d.xpm
SO /Users/asebrani/Downloads/5a6d1b2bfc4f3b98639fa199c9c48d0d.xpm
WE /Users/asebrani/Downloads/5a6d1b2bfc4f3b98639fa199c9c48d0d.xpm
EA /Users/asebrani/Downloads/5a6d1b2bfc4f3b98639fa199c9c48d0d.xpm
F 0,255,0
C 255,1,0

11111111111111111111
100000000000001111111111111
10000000000000E00000000111
111111111111111111111111111
