NO texture/NO.xpm
SO texture/SO.xpm
WE /Users/asebrani/Desktop/cube3d/cub3d/texture/816f07617472a381be10518fe9c42f95.xpm
EA texture/kkkkkk.xpm
F 0,0,0
C 0,0,0

1111111
10000111
101011111111111
100N01
111111
