C 0,0,0
NO texture/NO.xpm
SO texture/SO.xpm
WE texture/NO2.xpm
EA texture/kkkkkk.xpm
F 0,1,255

111111111111111111
1111111111
111111111E111111
111111111111111111
