NO texture/NO.xpm
SO texture/SO.xpm
WE texture/WE.xpm
EA texture/EA.xpm
F 0,255,0
C 0,0,0

111111111
100000001
100000001
100000S01
111111111
