NO texture/NO.xpm
SO texture/SO.xpm
WE texture/WE.xpm
EA texture/EA.xpm
F 123,123,123
C 250,250,250

111111
1111111
111111E111
11111111
1111111
