NO texture/NO.xpm
SO texture/SO.xpm
WE texture/WE.xpm
EA texture/EA.xpm
F 34,56,78
C 200,100,50

111111111
100000001
1W0000001
100000001
111111111
