NO texture/NO.xpm
SO texture/SO.xpm
WE texture/WE.xpm
EA texture/EA.xpm
F 50,50,50
C 100,150,200

1111
1001
1N01
1111
