NO texture/NO.xpm
SO texture/SO.xpm
WE texture/WE.xpm
EA texture/EA.xpm
F 255,200,150
C 100,100,100

111111111111
100000000001
100000000001
100000S00001
100000000001
111111111111
